DemCount,DemScore,Init_Intensity,RepCount,RepScore,subreddit,CombinedCount,PolClass
324,100.10979525873348,35,301,92.27763885947422,All,625,Democrat
319,99.51806741931688,59,182,79.05777624033027,AskReddit,501,Democrat
325,143.3508844345262,123,177,104.46667381727465,askscience,502,Democrat
268,89.07756397309396,27,234,80.1286272472629,asoiaf,502,Democrat
360,56.27714131155143,2,141,40.495513930059154,aww,501,Democrat
190,61.225108213347525,39,212,76.49547353021397,blog,402,Republican
227,85.58458335141631,52,203,80.24325787138895,books,430,Democrat
368,54.39851698114015,3,132,39.27025685435333,cats,500,Democrat
169,80.1003505202809,72,333,125.1969488153271,CFB,502,Republican
213,115.47314854531567,140,287,136.6670353785636,communism,500,Republican
470,417.45706151164967,469,31,66.92868125009409,democrats,501,Democrat
489,41.72330815226335,1,13,9.898811840274364,dogs,502,Democrat
285,71.76227199114152,8,215,65.51107619723538,EarthPorn,500,Democrat
181,74.2893354423565,51,134,63.58191727069922,explainlikeimfive,315,Democrat
245,69.35378360869313,6,256,71.75511893109532,funny,501,Republican
301,81.74735014600384,20,201,69.97168177322403,gameofthrones,502,Democrat
296,72.82730027825966,13,204,65.14762253181533,gaming,500,Democrat
249,72.62183381591609,5,252,70.37388874041531,gifs,501,Republican
389,53.13940881789745,1,112,34.75695880419907,HumansBeingBros,501,Democrat
146,73.6119047761921,111,222,102.64263893028226,IAmA,368,Republican
277,216.9478486611124,329,223,167.70894143086588,Liberal,500,Democrat
230,134.70685936185978,162,272,130.89561968737087,Libertarian,502,Republican
148,39.74024145024393,6,70,26.595594049635736,malefashionadvice,218,Democrat
214,77.08708891885348,33,212,78.88090682964591,movies,426,Democrat
222,77.3509405781209,19,280,85.44277473066467,Music,502,Republican
63,29.353615391957877,36,123,50.251254565351104,news,186,Republican
314,120.36146908831506,93,188,86.59414295843624,nfl,502,Democrat
150,67.31903911589708,1,350,78.95117026360268,nsfw,500,Republican
278,64.94153637405499,6,223,62.27694714202644,pics,501,Democrat
30,92.83689365339458,471,470,372.0126642697044,Republican,500,Republican
263,138.82624337783687,174,237,125.91291818168399,science,500,Democrat
262,105.16693144972311,67,240,87.90136586337707,soccer,502,Democrat
287,98.66784589603591,45,214,83.1770438412417,television,501,Democrat
309,180.01969061818693,224,193,118.15549652561606,The_Donald,502,Democrat
318,142.00656624800382,154,182,103.59662525579621,todayilearned,500,Democrat
245,80.81006076464436,20,255,83.60216958260983,videos,500,Republican
136,103.02353394173602,173,307,153.7466097642978,worldnews,443,Republican
